||||||||||||||||||||||||| :0
|@|||**********$****||||| :1
|*|||**|||||||||||||||||| :2
|*|||**********||||$$***| :3
|*||||||||**|**|||||**||| :4
|*||*****|**|******|****| :5
|*||*****|**|****$*|****| :6
|*||********|******|||**| :7
|******$*|||||||||||****| :8
|**********||******|||**| :9
|**||||********||*******| :10
||||||||||||||||||||||||| :11
0123456789.11.14.17.20.23       
		
Key:
* - open space 
| - wall
$ - pot of gold
@ - outside
? - Marker