|||||||||||||||||||||||||||||||||||||||||||||||||||||||||||||||||||||||||||||||||||||||||||||||||||
| |     |       |         |                               |                 |                     |
| | | ||| | ||| | | ||||| | ||||||| ||||||||||||||||||||| | | ||||||||||||| | ||||| | ||||| | ||| |
|   |     |   |   |   |   | |     |       |     |       |   | |       |   |   | |   | |     |   | |
| ||||||||||| ||| | | | ||| | ||| | ||||| | ||| | | ||| ||||| | ||||| | | ||||| | ||||| | ||||||| |
|     |     |   | | | |     | |   | |   | | |   | |   |   |   | |   |   |       |     | |   |   | |
||||| | | | ||| | ||| ||||||||| | | ||| | | | ||| | | ||| | ||| | | ||| ||||||||||||| | ||||| | |||
|   | | | |   | | |   |   |     | | |   |   | |   | | |   |   |   |   |         |     |     | |   |
| | | | | ||||| | | ||| | | ||||| | | ||||| | | | | | | | ||| | ||||| ||||||||||| | ||||||| | | | |
| |   | |   |   | |   | | |     | |   |   | |   | | | | | |   | |   |   |         |       |   | | |
| ||||| | ||| | | ||| | | ||||| | ||||| | ||||||| | | | ||| ||||| | ||| | ||||||||||| ||| ||||||| |
|       | |   | |   |   |     | |       |   |     | | |   | |   | |   |   |   |     |   |       | |
| ||||||| | ||||||| ||||| ||| | | ||| ||||| ||||||| | ||| ||| | | | | ||||| | ||||| | | ||||||| | |
|       | | | |   |     |   | | |   |   |   |   |   |   |   | |   | |     | |       | |       | | |
| ||||||| | | | | ||||| ||||| | | | ||||| ||| | | ||||||||| | | | | ||||| | | ||||||||||| ||| | | |
|     |   | |   | | |   |   |   | | |     |   |   |   |     | | | |     | | | |   |     |   | | | |
||||| | ||| ||||| | | ||| | ||||| | | ||||||||||||||| | ||||| | ||||||| | | ||| | | ||| ||||| | | |
|   | |   |       |   |   |   |   | | |       |       |       | |   |   |   |   | |   |     | | | |
| ||| | | ||||||||||||| ||||| | | | | ||||||| | | ||||| | ||||| | | | ||||||| ||| ||| | ||| | | | |
| |   | |     |       | |   | | | | |         | |     | | |   | | | |         |   |   |   | | | | |
| | ||| | ||| | | ||| | | | | | ||| ||||||||||| ||||| | ||| ||| | | ||||||||||| ||| ||||| | | | | |
|   |   |   |   | |   | | | | |   |         |   |     |   | |   | | |         |   |   |   |   | | |
| ||| | ||| ||||| | ||||| | | ||| ||||||||| | ||| | ||||| | | ||| | | ||||| | ||| ||| ||||||| | | |
| |   | |   |     | |     | | |   |       |   |   |   | |   | |   | |     | |   |   |       | | | |
||| ||| | ||| ||||| | ||| | | | ||| ||||| ||||||||||| | | ||| | ||| ||||| | ||| ||| ||||||| ||| | |
|   |   | |   |     |   | |   |     |   |           |   |   | | | |       | | |   |     |   |   | |
| | ||||| ||||| | ||||| | ||||||||||| | ||||||||||| | ||||| | | | | ||||||| | | | ||||||| ||| ||| |
| | |   | |     |   |   | |         | |           | |     | | | | |     | |   | |   |     | | |   |
| ||| | | | ||||||||| | | | | ||||| | ||||||||||||| | ||| | | | | | ||| | ||| | ||||| ||||| | | |||
|   | | | |           | |   | |   |   |         |   | |   | |   | |   | |   | |   |   |     | |   |
| | ||| | ||| ||||||||| ||||||| | ||||| ||||||| | ||| | ||| ||||| ||| | ||| | ||| | ||| ||| | ||| |
| |     |   |         | |   |   |       |       | |   |   |       | | |     |   | |   |   | | |   |
| ||||||||| | | | ||| | | | | | ||||||||| ||||||| | ||||| ||||||||| | ||||||||| | ||| ||| ||| | |||
|   |   |   | | | |   |   |   |       |   | |   | |     |       |   | |     |   |   |   | |   | | |
||| | | | ||| | ||| ||||||||||||||||| | ||| | | | | ||| ||||||| | ||| | ||| ||||||| | | | | ||| | |
| | | |   | | | |   |           |     |     | |   |   | |   |   |     |   | |   |   | |   |   |   |
| | | ||||| | | | ||| ||||||||| | ||||| ||||| ||||| | | | | | ||||||||||||| | | | | | ||||||| |||||
|   |   |   | | |     |     |   |     |   |   |   | | | | | |     |   |   | | |   | |       |     |
| ||||| | ||| | ||||||| ||||| ||||||| ||| | | | | ||| | | | ||||| | | | | | | ||||||| ||| | | ||| |
|   |   |     |       | |   | |       |   | | | |   | | | |   |   | |   |   |       |   | | |   | |
| | | ||||| | ||||||| | | | | | ||||||||||| ||| | | | | | | | | ||| | ||| ||||| ||| | | ||| ||| | |
| | | |   | |     |   | | |   |   |     |   |   | | | | | | | |     |   |     |   | | | |   |   | |
||| | ||| | ||||| | ||| | ||||||| | ||| | ||| ||||| ||| | | | ||||||||| | ||| ||| | | | | ||||||| |
|   |   | |   |   | | |   |   |   |   | |   | |   |   |   | |       | | |   | |   | | | |   |     |
| ||||| | ||| ||| | | | ||| | | | ||| | ||| ||| | ||| ||||| ||||||| | | | | | ||||| ||| ||||| | |||
|   |   | | |   | |   |   | |   |   | |   |   | |   | |   | |     | |   | | |     |   | |     |   |
| | | | | | ||| | | ||||| | ||||||| | ||| ||| | ||| | | ||| | | ||| | ||| | ||||| ||| ||| |||||||||
| | | | | | |   | |   |   |       | |   |   |   | |   |   |   | |   |   | | |   |   |   |         |
||| | ||| | | | | ||||| | ||||||| ||||| | | ||||| ||||||| | ||||| ||||||| | | ||||| ||| ||||||||| |
|   |   | |   | |   |   | |     |     | | |     |   |   | |   |   |       | |   | | | | |   |   | |
| ||| | | ||||||||| | | ||| ||| ||||| | | ||||| ||| | | | ||| | | ||||||||| ||| | | | | | | | ||| |
|   | | | |   |     | | |   |   |   |   |     |     | | | |   | | |       |     | |   | | | |   | |
||| | | | | | | | ||| ||| ||| ||| | ||||||||||||||||| | | | ||| | | | ||| | ||||| ||||| | ||| | | |
|   | |   | |   |   |   |   |   | |                   | | | |   | | | |   |     |   |   |   | | | |
| ||||||||| ||||||||| | ||| | | | | ||| ||||||| ||||||| | | | ||||| ||| | ||||| ||| | ||||| ||| | |
|     |   |   |     | | |   | |   |   |   |   | |     | | | |     | |   |     | |   |       |   | |
||||| ||| ||| | ||| ||| | ||| | ||||| ||||| | ||| ||||| | | ||||| ||| ||||||||| | ||||| ||| | ||| |
|   |   |     |   |     |   | |     |       | |   |   |   | |   |     |   |   | |     |   | |   | |
| | ||| ||||| ||| ||||||||| | ||| | ||||||||| | ||| | ||||| | | ||||||||| | | | ||||| ||| | ||| | |
| |   |     |   | |         |   | | |       | |     | |     | |         |   |   |   | | | |   | | |
| ||| ||||| ||| | | | ||||||||| | | | | ||||| | ||||| | ||||| | ||||||| ||||||||| | | | | | | | | |
| | | |     |   |   |         | | |   |   |   |   |   |     | |       | |         |   | | | | |   |
| | | | | ||| ||||||||| ||||||| ||||||||||| ||||||| | ||||| | | ||||| | | ||||||||||||| | | | |||||
| | | | |   |         |     |   |         |         |   | | | |     | |   |     |     |   | |     |
| | | | ||| ||||||||| ||| | | ||| ||||||| | ||||||||||| | | | | ||| | ||||| | | | ||||||||||| ||| |
| |   |   |         |   | | |   |     |   | |     |   |   |   |   | |   |   | | |           |   | |
| ||||||| | ||||||| ||| | | | | ||| ||| ||| | ||| | | ||||||||||| | ||| | ||| | ||| ||||||| ||||| |
|   |     | |   | | |   | | | |   | |   |   |   |   |   |     |   | | | |   | |   | |     | |   | |
||| | | ||| | | | | | | | | ||||| ||| | | ||||| | ||||| | ||||| ||| | | ||| ||| | ||| ||| | | | | |
|   | | | |   | | | | | | |     |     | | |   | |   |   |       |   | |   |   | |     |   | | | | |
| ||| | | | ||| | | | ||| ||||||||||||| | | | | | | | ||||||| ||| ||| | | ||| | ||||||| ||| | ||| |
| |   |   | |   | | |   |   |   |     | |   | | | | |   |   |   | |   | |     |       |     |     |
| | | ||||||| ||| | ||| ||||| | ||||| | ||||| | | | ||| | | ||||| | ||| | ||||||||||| | |||||||||||
|   | |       |   | |   |   | |     | |     |   | | |   | |       | | | |     |     | |           |
| ||| | ||||||| ||| | ||| | ||||||| | ||| | ||||| | | ||| ||||||||| | | | ||| | ||||| | ||||||||| |
| |   |         | | | |   | |       |   | |   |   | | | | |         |   |   | |       |   |     | |
| | ||||||||||||| | | | | | | | ||||||| ||| | ||||| | | | | ||||||||||||||||| ||||||| ||| | | | | |
| |               | |   | |   | |     |   | |     | |   | |   |         |   | |     | |   | | | | |
| ||||||||||||||| | ||||||||||||| | | ||| | ||||| ||||||| ||| | | ||||| | | ||| ||| | | ||| | | | |
|   |     |     | |         |   | | |     | | |   |     |     | | |   |   |   | |   | |     | | | |
| | | | | | | | ||||||||||| | | | | ||||||| | | ||| | | ||||||| | ||| | ||||| ||| | | ||||||||| | |
| |   | |   | |           |   |   |       |   | |   | | |       |   | |     |   | | |   |   |   | |
| ||||||| ||| ||||||||||| ||| ||||||||||| ||||| | ||| | | | ||||||| | | ||| ||| | | ||| ||| | ||| |
| |     | | | |   |     |   |           |   |   | |   |   |       |   |   |   | | |   |     | |   |
| | ||| | | | | | | ||| | | | ||||||||| ||| | ||| ||||||||| ||||| | ||| | | | | | ||| ||||||| | |||
|   |   |   |   | | |   | | | |       |   | | |   |   |   |   |   |   | | | | |   |   |     | |   |
||||| | ||||||||| | | ||||| | | | ||| | | | | | ||| | | | ||| | ||||| | | ||| ||||| ||| | ||| | | |
|     | |   |     | |       |   |   | | | | |   |   |   |   | |   |   | |   | |   |     | |   | | |
| ||||| | | ||||||| | ||||||||||||| | ||| | ||||||| ||||||| | | | | ||||||| | ||| | ||||||| ||||| |
| |   | | |         |         |   | | |   | |     |       | | | | | |   | | |     | |     | |   | |
| ||| | | ||||||||||||||| ||||| | | | | ||| | ||| ||||||| | | ||| | | | | | ||||||||| | | ||| | | |
|   | | |               | |   | | | | | |   | | |   |     | | |   |   |   |       |   | | |   | | |
||| | | | ||||||||||||| | | | | | | | | | ||| | | | ||||||| | | ||||||||| ||||||| | ||||| | | | | |
|   |   |         |     | | | | | | | | |     | | | |     | | | |       |     |   | |   |   | | | |
| ||||||||||||| | | ||||||| | | | | | | ||||||| | | | | | | | | ||||| | | ||||| ||| | | ||||||| | |
|     |   |   | | |   |   | | | | | | |     |   | |   | |   | |     | | | |   | |   | | | |     | |
||||| | ||| | ||| | | | | ||| | ||| | ||||| | ||||||||||||||||||||| | | ||| | | | ||| | | | ||||| |
|     |     |     | |   |     |     |     |   |                     | |     |   |     |   |       |
|||||||||||||||||||||||||||||||||||||||||||||||||||||||||||||||||||||||||||||||||||||||||||||||||||
