1111111111111111111111111
1@111**********$****11111
1*111**111111111111111111
1*111**********1111$$***1
1*11111111**1**11111**111
1*11*****1**1******1****1
1*11*****1**1****$*1****1
1*11********1******111**1
1******$*11111111111****1
1**********11******111**1
1**1111********11*******&
1111111111111111111111111
//

Key:
* - open space
1 - wall
$ - money
@ - start
& - exit/finish/goal