|||||||||||||||||||||||||
|@|||          $    |||||
| |||  ||||||||||||||||||
| |||          ||||$$   |
| ||||||||  |  |||||  |||
| ||     |  |      |    |
| ||     |  |    $ |    |
| ||        |      |||  |
|      $ |||||||||||    |
|          ||      |||  |
|  ||||        ||       |
|||||||||||||||||||||||||

