|||||||||||||||||||||||||||||||||||||||||||||||||||||||||||||||||||||||||||||||||||||||||||||||||||
| |     |      $    $ |  $     $  |   $ $  $  | $     |      $      $   $      $ $      $   |     |
| | |$| | ||||||| | ||| | ||| ||||| ||||||||| | |$| | | | ||||||||||||| | ||||||||||||||||| | | | |
|   | |   |   |   | |   |   |     |   |  $  |   |$| |   | |   |   $   |$|  $    | $$|     |   | | |
| |||$||||| | | ||||| | ||| ||||| ||| | | | ||||||| |$||| | | | |||||$| | ||||| | ||| |$| ||||||| |
|  $| |   | |$$ |     |   |   |   |   |$| |$|       |  $|   | | |   | | |$    |   |$  | |   |   | |
||| | | |$| |||||$| |||||$| ||| ||| ||| | | | ||||| ||| | ||| ||| | | | ||| | ||||| | | ||||| | | |
| | | | | | $ |   |   |$  | |   |   |   | |   |   | | | |   |   | |   |   | |  $  | | |   |   |$  |
| | | | | |||$| ||||| | ||||| ||| |||$| | ||||||| | | | ||||| | | ||||||| ||||||||| | | | | |||||||
| | |   |   |   |   | | | $ | |$  |$  | |     |   |   |     | |   |  $  |     |   | | | | |   |   |
| | | ||||| |||||$||| | |$| | ||||| ||||||||||| | ||||||||| | ||||| ||| | ||| | | | | ||| ||| | |||
| $ | $$|   |  $|     | | | |$     $|$  | $     |   |     | |   |   | |$|$  |$  |   | |   |  $|   |
| ||||| | |||||$||||||| |$|$||||||||| | | | ||||||| ||||| | ||||| |$| |$||| ||||||||||| ||| ||||| |
| $ $ | | $     | |     | |  $$       |   |$|     |       |     | | |$  |   |   |$   $|$  | |     |
| ||| | ||||||||| |$||||| | ||||||| ||||||| | ||| |||||||||||||$| ||||||| ||| | |$||| ||| | | | |||
| $ | | |$$    $  |$    | |   | $ |       | |   | |   |       | |$  |   |     | | |   |   |   |   |
||| | | | | ||||||| | |$| ||| |||$||||||| | ||| | | |$| | ||| |$||| ||| |$|||||||$| ||| | ||||||| |
|   | | $ |       | | | | | |   $ |  $|   | |   |   | | | |   |   |$|   | |  $|   | |   |   |   | |
| ||| ||||| ||||| | ||| | | | ||||| |$| ||| | | ||||| | ||| ||||| | | ||| | | |$||||| ||||||| | | |
| |   |  $| |   | | |   |$| | |$  | | | |   | |   | | |   |     | | |   |  $|$| |   | | |     |   |
||| ||| | ||| | | | | | | | | | | | |$|$| |||$| | | | |||$|||||$|$| ||| | ||| | | | | | | |||||||||
|   |   | |   | | | | | | | | | |$  |   |     | |$| |    $|   | |   |   |$  | |  $|   | |  $      |
|$||||||| | | | | | | ||| | ||| ||||||||||||| | | | ||||||| | | ||||| | ||| | ||||||| | ||||||||| |
| |   $ |   | |   | |  $  |   | | $   |     | | |   | $   | | | |   | |   | |      $| | $   |     |
|$||||| | ||| ||||| |||||||$| | | | | | ||| | | ||||| | | |$||| | |$| ||| | ||||||| | ||||| | |||||
|       | | | |   |       | |   | |$|   |   | |     | | | |   |   |   |   |       | | |  $  | |   |
| ||||||| | |$| | ||||||| ||||||| ||||||||||| | ||| |$| | ||| ||||||| ||||| ||||| | ||| |$||| | | |
|     |   | |   | |  $  |       |         | | |$  |   | |$  |$      | |   | $ |$| |   | | |   | | |
| |||$| | | ||||| ||||| | ||||| ||||||||| | | | |$| ||| ||| ||||||| | | | ||| | | | | | | | ||||| |
| |   | |$|     | $     |     |         | |  $| | |$  |   |       | |$| | |   | | | |   | |     | |
| | ||| | ||||| ||||| |$||||| | ||||||| | | ||| | ||||||| ||||||| | ||| | | ||| | ||| |||$||||| | |
| | $ | | |   | |$  | |   |   |     |   | | $ | | | $$$$  |$  |   | $ | | |     | $ |   |     |   |
| ||| | |$| | | ||| | ||||| | |||||||$| |$||| | | | ||||||| ||| | ||| ||| ||||||||| |$| ||||| |||||
| $ | | | | |   |  $|$|   $$|   |     |$|$|   | | |         |   |$  |   | |   |$ $$ | |   |   |   |
| ||| | |||$| ||| ||||| | ||||| | ||||||| | ||| | |$||||||||| ||||||||| | | | | | ||| ||| |$||| | |
| | $ | |   |  $|$ $|   |   |   |     $$  |$|   | | |    $  | |       | |   |   | |  $|   |   | | |
| | ||| | | ||| ||| | | |||$| ||||||||||||| | |||$||| | ||| | | | ||| | ||||||||| | ||| ||||| | | |
| | |   | | |   | |   |  $| |     $$      | |  $|     | |$ $|   |   | |     | |   |  $|$|     | |$|
||| | ||| | | |||$| ||||| | ||||||||||||| | ||| ||||||||| | |||||||||$||||| | |$||||| | | ||||| | |
|   |     | |    $|   |   | | $     |   | | | |$    |   | |     |   |       | $ |     | |       | |
| ||||||||||||||||||||| ||| | | ||| | | | | | ||||| | | | | ||| | | ||||| |||||||$||||| ||||||||| |
|   |$ $      |    $  | |   | | |   | |   |   |     | |  $| | | | |   $ | |   |   |   | |       | |
| | |||$||||| | ||||| | | |||$| | ||| | ||||||| ||||| | ||| | | | | ||| | | | | ||| | | ||||||| |$|
| | $ |  $|   | |   |   |     | | |   |      $|   |   | | |$  | | | | $ | | |   |   | | |       | |
| ||| ||||| | | | | ||||||||||||| |$|$||||||| ||||| | | | ||||| | | | ||||| | | | ||| | | | ||||| |
|   |   | $ | |   | |   $ |       | | |     |$|$|   | |   |  $| | | |   |   | |$|   |   | |     |$|
| |$||| | ||| ||||| | ||| |$||||||| | | | ||| | | | | ||| | | | | ||||| | ||| ||||| ||||| | ||| | |
| | | | | | |  $| $ | | $ | |       | | | |   | | | |   | | | | | $ $ |   |   |   |     $ |   |$| |
| | | | | | ||| | ||| |$||| | |$||||| | ||| ||| | |||||$||| | | ||| | ||||| ||| | ||||||||| ||| | |
| |   | $ |   | |     | |$  |$|     |$|   |     |   |   |   | |   | |     | |$$ | |$$     | |   | |
| ||||||||||| | ||||| ||| ||| | ||| | ||| | ||||||| | ||| | | ||| ||||||| | | ||| ||||||| | | ||| |
|$     $  $   |  $  | | $ |$  | $ | |   | |    $|   |    $| | | |$|   |   |$|   |  $ $  |$|$| |   |
| ||||||||||||||||| ||| ||| ||||| | ||| | ||||| | ||||||| |||$| | | | | ||||||| ||||||| | | | | | |
|    $|   | $     $ |   |   |  $  | | | |   | | |       | |   | |   | | |     |  $| $   | | | | | |
| ||| | | |$| ||||||| ||| ||||||||| | |$||| | | | ||||| |$| ||| | ||| | | |$| ||||| ||||| ||| | | |
| |   | |   | |     $ |   |$      |   |     |   | |   | | |     | $ | | $ | | | $   |   |     | | |
| | ||| ||||||| ||||||| ||| ||||| | ||||||||||| | | | | | ||| ||| | | ||| | | | ||||| | ||||||| | |
| |   |      $|   |     |   |   | |      $    | | | | | |$  |   | | |   | | |   | $   |   |   $ |$|
||||| ||||||| ||| | ||||||||| |$| | ||| ||||| ||| | | | ||| ||| | |$||| ||| ||| | | ||||| | ||| |$|
|   | |    $  |  $|   |       |   |   | |     |   | |   |   | $ | |   |$  |   | | |    $| |   |$| |
|$| |$| ||||||| ||||| | ||||||||||||| ||| ||||| |||$||||||||||||| ||| ||| ||| ||| |$||| | ||| ||| |
| |   | |     | |   |$$ |       |   |   | |     |   | $$  |  $$$|   |   |  $|   $ | |  $|   |   | |
| | ||| | ||| | | | ||||| |$||| ||| ||| | | ||||| | | | | | ||| ||| ||| | | | ||| | | ||||| ||| |||
| | |   |   |   | |$|   | |   |   |$  | | |     | | | |$|   |   |   |   |$| | $ | | |     |   |   |
| ||| | ||| |||||||$| | | ||| ||| ||| |$| ||||| |$|||$||||||| |$| | | ||||| ||| | |$||||| | | ||| |
|   | |$| $ |     $ | | | |  $|  $|$  | |   |   |   |   $ | $ | | |$|$|     |   | |     | | | $ | |
||| | ||| | | ||||||| | | | ||| ||| |$|$||| | ||||| ||||||| ||||| | | | ||||||||| ||||| | ||||||| |
|  $| |   | | |       |   | $ |   | | | |   | |   |       |   |   | | |   | $ | | |$   $| |       |
| |||$| ||||| | ||| ||||||||| |$| | ||| | ||| | ||| ||||| ||| |$|||||$||| | | | | | ||||| |$|||||||
|   | | |     |   | | |$  |   | | $ |   | |   |  $|  $  | |   | |$   $| | | | | | |$|$  | |       |
| ||| | | ||||||| | | | | | ||||||||| ||| | ||||| | ||| | | | | | ||||| | ||| |$| | | |$| | ||||| |
| |   | $ |    $  |   | |$ $|  $    |   | |   |   |   |$|   | | |     | | | $ | $ | | |$  |   |   |
| | ||||||| | ||||||||| ||||| ||||| ||||| | | | ||||| | ||||||| |||||$| | | ||||||| | ||||||||| |||
| |      $  |     | |   |   | |     |     | | |     | |    $  | |   | | |  $| $   | | |       |  $|
| ||||||||||||| | | | ||| | | | ||||| ||||| | ||||| | ||||||| | |$| | | | ||||||| | | | | ||| ||| |
|        $|   | | | |$|$ $| | |   |   |   | | $ |   |       | |   | | | |$  |     | |   |   |   | |
| ||||||| ||| | |$| |$| ||| | | | | ||| | ||||| | ||||||||| | ||||| | | ||||| | ||| | ||||| ||||| |
|       | |   | |   | | |$  | | | | | $ |   |   | |  $  | |$| |     |   |    $|$|   |     | |     |
| ||||| | | ||||||||| | | ||| | | | | | ||| | ||| | ||| | | | | ||||||||| ||||| | ||||| ||| | |||||
|   |   | $ |       | | |     | |   | |   | | $   | | | |   | |     $    $|   | | |   | |   |  $  |
| | | ||||||| ||||| |$| ||||||||||||| | | | ||||||| |$| ||||| ||||||||||||| |$| | ||| | | | ||||| |
| | |   |   |     |   | $         |   |$| |       $ |   |$  | $  $    | $ | |   | $   | |$| | $ | |
| |$||| | | ||| | ||||| ||| ||||| | ||| |$| ||||||||||||||| | ||||||| | | ||| ||||||||| | ||| | | |
| |   | $ |   |$|     |   |   | |  $|$  | |     |   $ $ $ |$|       | | |   | |       | |   | | | |
| ||| ||||||| ||| ||| ||| | | | | ||| ||| ||||||| |$||||| | ||||||| | ||||| | | ||||| | ||| ||| | |
|   | |     |   |$  | |  $| |$  |   |   | |   $   |$  |   | |   |   |     | |   | |   | | |    $| |
| | |$| |$||||| ||| | ||||||||||||| ||| | | ||||||||||| ||| | | ||||||||| | ||||| | ||| | ||||||| |
| | | | | |  $  |   |$|  $  | |  $|   | | $ |        $|     | |       |$  | |    $|$|   | |  $ $  |
||| | | | | ||||||| | | ||| | | | ||| |$||||| |$||| | ||||||||| ||||| |$||| | |||||$| ||| | |||||||
|   | | | | |     | |   | $ |   | |   |     | |  $| | |       | $ |   |     |   $ |$|$$$ $| | $  $|
| ||| | | | |$| | ||||||| ||||||| | ||||||| | ||| | | | ||||| ||||| | | ||||||||| | | ||||| |$||| |
| $ |$  |$|   | |  $|   |$$     | |       |   |  $|$|   |   |       | |     |   |   |   |  $| |$  |
||||| ||| ||||||||| | | ||||||| | | ||||| ||||||||||||||| | ||||||||| ||||| ||| | |||||||$||| | | |
|  $| |$$ |   $ $ |   |     |   | |     |   |           $ |$|       |$  |   |   | |     |     |$|$|
| | ||| ||| ||||| | ||||||| | | | ||| ||||| |$||||||||||||| | ||||| ||| | ||| ||| | ||| | ||||| |||
| |   |     |     | | $$|   | | |   | |   | | |       |     | |   |     |     |   | |$  | |$ $|   |
| ||| ||||||||||||||| | ||||| | ||| ||| | | | | ||||| | ||||||| | ||||||||||||||||| | ||||| | |||$|
|   |         $       |$   $  |   |     | $$|$  |     |         |                   |      $|     |
|||||||||||||||||||||||||||||||||||||||||||||||||||||||||||||||||||||||||||||||||||||||||||||||||||
