|||||||||||||||||||||||||||||||||||||||||||||||||||||||||||||||||||||||||||||||||||||||||||||||||||
| | |@    @           |     @           |   |@@ | @   |      @@@      @   |@@       @@@           |
| |@| | ||| ||| | ||| ||||| | ||||||||| | | | |@| ||| | | ||||||||||| ||| | ||||||||||||| ||||||| |
|@|   | @ | |   |   |   |   |   | @   | | |   | |   |   | @ @   @   |@|   |   |     |   |       | |
| ||||||| ||| ||||| ||| | | ||| ||||| | |@||||| ||| ||||||||||||||| | | ||||| | |@| | | | ||||| | |
|     @ | |   |   |   |   |@ @| @   |@| @ | @ | | @ |@    @    @    | |@  |   | | |   | | |     |@|
| |||||@| | ||||| |||@||||||| ||||| | | ||| ||| | ||||||||| ||||||||| ||| | ||| | ||||| ||| ||||| |
|@    |   | |     | |@  |@  |     |   |@ @|     |   |     |@|      @|   | |   | |     |  @| |   | |
| ||| ||||| |@||||| | | | | ||||||||| ||||||||||||| | ||| | | | ||| | | | ||| | | | | ||| ||| | |@|
|@@ |@|   |   |     | | | |         |   |    @    |  @|   |   | |   |@| |   @ | | | |   |@ @| | | |
||| | | |@||||| | ||| | | | ||||||| ||||| | ||| |@|||||@| ||| | | ||||| ||||||| | |||||@||| |@| | |
| | | | |     @ |   | |@  | |   |   |     |   |@|   |   |  @| | | @ |@  |       |   | |   | | | | |
|@| | | | | ||||||| |@||||||| | | ||| ||||||| | ||| | ||||| ||| ||| | |@| ||||||| | | |@| |@|@| | |
| | |   | | |   |   |         | |     |     | |@  | | |   |   |   |@|@| |       | |@  | | | @ | | |
| | | ||| ||| ||| |||||||||||||@| ||||| ||| | ||| | | | | ||| ||| |@| ||| ||||| | ||||| | |||||@| |
|   |  @|@@ |   |  @@       |   |    @|   |@  |   |   | |   |@  | | |   | |   | |@  |  @|     | | |
| ||||| | | ||| ||||||||||||| |@||||| ||| ||||| ||||||| ||| |||||@|@|||@|||@| | |@| ||||| ||||| | |
|   @ | |@|     |       |   | | | @@| |   |     |   | |@  |   @ | |   | |   | @ | |     | |     | |
|@||| | | |||||||@| ||| | |@| ||| | | |@|||@||||| | |@||| ||||| | ||| | | | ||||||||| | ||| ||||| |
|   | | | |   |  @|   | | |   |   |   |  @|@    | | @ |   |   |@  |  @|@  | |   |   | |   |@   @| |
||| | | ||| | |@| ||| | | ||||| |||||||@| ||||||| | |||@||| |@||||| ||||||| |@|||@| ||||| | |||@| |
| | | | |   |@| | |@  | |   |  @| @   | | |@@ @@  | |@@ |   |  @|   |       |  @  |       | @ | |@|
| | | | | |||@| | | ||| ||| ||||| ||| ||| | | ||||| | | | ||||||| ||||||| ||||||||||||| ||||||| |@|
| | |@|   |@| @ | |   |@|   | @@| |   |   | |     | |@| |   | |   |     |  @@   | @   |   |   | | |
| | | |||||@||||||||| | | ||| | | | | | ||| | ||||| | ||||| | | |||||||@| ||||||| ||| ||| |@|@| | |
| | | |     |    @  | | |   | |   | | | |   | |@    | @   | | |         |  @|@    |   |   |@|   |@|
| | | | |@||| | ||| | | | | ||||||| | |@| ||| | ||||||||| | | ||||||||||||||| ||||| ||| ||| ||||| |
|   |   | |   |   |   | | |   |@  | | |@  | @@|@    @  @|   | @ @    @    |   |@    |  @|   |   |@|
| ||||||| | | ||||||||| | ||| | | |@||||| | ||||||||||| ||||||||||||||||| | ||| | ||||||| |@| | | |
|   |   | | |@  |   | @ |@|   | | |   @ | |  @        |   @@ @  |       | |   | |   |     | |@| | |
|@| | ||| | ||||| |@| ||||| ||||| ||||| | ||||||| ||| ||||||||| | | | | | | | |@|||||@||||| | | | |
| | |@    |    @| | |@|   |       |   | |    @ @| | | @@  @   |   | | |@  | |@|   @@|   |@@@| |@| |
| | ||||||||||| | ||| |@| ||||||||| |@| |@|@||| | | ||||||||| ||||| ||| ||| | ||||| ||| |||||@|@| |
| |          @|   |   | | @      @@ |   | |@|   |   | @ |   | |   |   |@  | | |   |     | @ | |   |
| ||||||||||| ||||| |||@| | ||||||||||||| | | ||||||| | |@| | ||| | | ||| |@| | |@||||||| | | |||||
|  @| @ @  @| |   |   @ | | |     @ | |  @| | |@  |   |   | |   | | | | | | |  @| |       | @ |   |
||| |@||||| | ||| | ||| | ||| |||||@| | ||||| |@| | ||||||| ||| | |@| | | | ||||| | ||||||||||| |||
|   | |@  | |   | |   | |   |    @|  @| | |   | | | | @   |   | | | | |  @|    @| |@   @@  @@@|   |
| ||||| | | | | | ||| | ||| ||||| |||||@| | ||| | |@| |||@|@| | | ||| |||||@||||| ||||||||||| ||| |
|@  @   |   | |   |   |  @| |@@ |   |   | |@    |   |   | | | | |@@   |   | |   |           |    @|
| ||||||| ||| | ||| ||||| | | | |||@| ||| | ||||| |||||@| ||| | |||||||@| ||| | ||||||||||| | | |||
|  @    | | @ |@@ | @   | | @ |   |   | @ |     |@@   | |   | |         |   | |        @| @ | |   |
| ||||| | |@||||||| ||| ||| ||||| ||||| ||||||| |||||||@||| |@||||||||||||| | | |||||||||@| | |@| |
|     | | |  @|   |   |   | |   |       |   @ |   |     | |   |  @|   |   |   | @ |   @   | | | | |
||||| | ||||| | | ||| ||| | | | ||||||||| | |@||| | |||||@| ||| |@|@| | | | |||||||@|||||||||@| | |
| |   |@|  @  | |   |   | |   |      @|@  |@|   | | @     | |   |   |  @| |  @|   | |   | |   | | |
| | | | |@||||| |||@||||| | ||||||||| | ||||||| |@| ||||| ||| | ||| ||||| | | | | | | | | | ||||| |
|   | | |@  @ |   |     | |       |@  |     @ | | | |   |@|   |   |  @|@  | | | |@  | |@| |@| @ | |
||||||| | ||||||| ||||| |@|@||| | | ||||||||| | | |||@| ||| | ||| ||||| |||||@| ||||| |@| | ||| |@|
| @ |   |@ @|     | |  @| |@  | | |        @| | |@ @|@|@   @|   |@  |  @|@  | | @   | |@| |   | | |
| | | ||||| | ||||| | |||@||| | |@||||| ||| | ||||| | | ||||||| ||| |@|||@| ||||||| ||| | | | | |@|
| |   |@  | | @     |   | | | | |     | | |   |     | |@| @   |   | | | @ |   |@  | @ | | | |   | |
| ||||| | | | ||||||||| |@| | ||||||| | | | ||| ||||| | | | ||||| | | |@| ||| | |@||| | | ||||||| |
| @ @ |@| | |   |   | |@@ |   |   |   |   | |   |   | | | | |     | |@@ |@  |  @|@  | | | @ |   | |
| ||| | |||@|@| | | | | ||||||| ||| | |||||@| ||| | | | | | | |||||@||||||| ||||||| |@| | | | | | |
|@  |@|     | |   |   |       | @   | |   | |     | @ |  @|@|@  |@  |     |     |   | | | |   | @ |
||| | ||||||| | ||||||||||||| ||||||||| | | ||||||||||||||| ||| | ||||| |@|@||| | | | |@|||||||||||
|   |@    | | |@    |    @  | |   @ @ | | |    @@   |   |@  | | |  @  | |@|   | | | | | | @ @     |
| | ||||| | | ||||| | |||||@|@| | ||| | |@||||||||||| | | ||| |@||||| | | ||| | | ||| | | ||||||| |
|@| |     | | |   |@| |     | |@| @ |   |  @    |   |@|@|     | |   | | | | | | | @@|  @| |    @| |
| ||| ||||| | | | | | | ||||| | ||||| ||||||||| | |@| |@|||||@| |@| | ||| |@| | |||@||||||| | | |@|
| |@  |     | |@|  @| |   |   |@  @ |         | | |@  |    @| | | |@  |  @| @ | | |@  @     |@|   |
| | | |@||||| | ||||| | | | ||||||| ||||||||| | | ||||||||| ||| | ||||| | ||||| | ||||| |@|||@|||||
| | | |       |@   @  | | |@ @|   | |         | |   |   | | @ | |@ @    |   |   |  @  | | |   | @@|
| | | ||||| ||||||||||| |@| | |@| | | ||| ||||| | | | |@| | | | ||||||||||| | | |||||@| | | |||@| |
| | | |@@@|   |    @|   | |@|   |@@ |@  | | @   | | @ |  @| | | | @  @| |   | | |   | |@|@| |@@ |@|
| | ||| | ||| |@| | | ||| |||||||||@||| | |@||||||||||| ||||| | |@||| | | |||@|||@|@| | ||| | |@| |
| |    @|@  | | | | | | |@    |   | |   | |       |   |   | @ |   |  @|   | |  @| | | |@|   | | |@|
| ||||||| | | | | | |@| | ||| |||@||| |||@| ||||| | | | | | |||||||@||||||| | | | | | |@| ||| | | |
| | @   | | |   | | |   | |   |   |  @|  @|@  |   |@| | | |         |  @  | | |   |   | |   | | | |
| ||||| | | ||||| |@||||||| | | | | ||||||||||| ||||| | | |||||||||||@|@| |@| ||||| ||| |||@| ||| |
|       | | |   | | |   |   | | |@|   |      @|     | | |           | | | | | |   | | |   | | |   |
| ||||||| | | | | | | | | ||||| | ||| | ||||| | ||| | | ||||||||||| | | |@| | |||@| | | |@| | | |||
|     |   | | | | |   | | @     |   | | |   | |@  |   |         |   | |@|  @|     |@  | |@|   |@ @|
| ||| | ||| | |||@| ||||| ||||||||| | | | | |@|||@|||||||||||||@| |||@| ||||| ||||||||| | ||||||| |
|   | |  @| |     |@| @ |       |   |@|@| |   |@  |         | | |  @  |    @|  @   @  | |     |   |
||| | ||||| ||||| ||| | ||| ||||| ||| ||| ||||||||| | ||||| | | ||||||||| | ||||||||| | |||||@| |||
|   |@@ |   |   | |   |   |   |   |   |@  | @   | @ | |   @ | |     |   | | @ |  @  | |   |@| |   |
||||||| | ||| | ||| | |||@||| | ||| |||@||| | | | ||| | ||||| | ||| ||| ||||| | ||||| | | | | ||| |
| @ |   | | @ | @   | |@ @|@  |   |   |   | |@|  @| |@|       |   |@@ |   |   |@  |   | |   | | | |
| | | |||@| |@||||||| |@| | ||| | | |@||| | ||||||| |@||| |||||||||||@|||@| ||||| | | | ||||| | |@|
| |   |   |@|       | | | |   | | | |     |  @@@|   | @ |@|     |   @@|@  | |   |   | | @ |@  | | |
| ||||| ||| | | ||| | | |@|||@||| ||||||||||||| | ||||| | | | | | ||||| ||| ||| ||||| ||| | ||| | |
|   |   |   | | |   |@| |   |   |   |         |@|      @| | | | |@|   |@| |   @@| @ | |   |  @@ | |
| |||@||| ||| ||| ||| |@||| ||| ||| | ||||||| | | |||||||@| ||| |@| | | | |@||| | |||@| ||||||||| |
| |   |   |@  |   |@  | |  @| |@  |   | |@  | | |   @  @|   |@  |   |   | | @ | | @ | | @     |   |
||| ||| | | ||| |||@||| | ||| | | | ||| | | | |@||| ||| ||||| ||||||||||| ||| ||||| | | ||||| |@| |
|  @|   | |   | |   |   |     | | | |   | |   |  @|   | |   |          @  |@|   | |   |     | |@| |
| ||| ||| |||||@| ||| ||||||||| | ||| | | |||||||@|||@| | | ||||||||||||||| | | | | ||||||||| | |||
|   @ |@  |   @ | |  @|@@ | |   |     | |       |   |@| | |     | @   |     | |@@ |   |   |@  | @ |
||||||||||| ||||| | ||||| | | | ||||||| |||||||@||| | | | ||||| ||| | | ||||||||||||| |@| |@| ||| |
|   | @ | @ |    @|  @@ |@|   |     @ |@ @ @  |   |@| |   |   | @ | | | |     @ |    @| |   | | @ |
| | | | |@|||@| ||||||| | ||||||||||| | |||@| ||| | | |||||@| |||@||| | | ||||| | ||||| ||||||| |||
| |   | |   | | |   |   | |   |  @|  @|   | | @ |   |       |   |  @  |@|   | @ |     |   |   | | |
|@| ||||||| | ||| | | ||| ||| | ||| ||||| | ||| | ||||||||||| | ||||||| | ||| ||||||||||| | | | |@|
| |   |@  | |   | | |   | |   | @   | @ @@|   | |@    @@|@@ | |      @| | |   |   |  @  |   |@| | |
| ||||| | | | | | |@||| | |@||||||||||||||||||| | ||||| ||| | ||||||| | | |@||| |@| | |@||||| | | |
|@      |   | | @ |   |  @|           @         |     |@   @|       |@  | |     |@  | |     @ |   |
|||||||||||||||||||||||||||||||||||||||||||||||||||||||||||||||||||||||||||||||||||||||||||||||||||
