|||||||||||
|   |     |
||| ||| | |
|       | |
| ||||||| |
|   |   | |
||| | | | |
|$| | |   |
| | | |||||
|   |     |
|||||||||||
