|||||||||||||||||||||||||
|@|||**********$****|||||
|*|||**||||||||||||||||||
|*|||**********||||$$***|
|*||||||||**|**|||||**|||
|*||*****|**|******|****|
|*||*****|**|****$*|****|
|*||********|******|||**|
|******$*|||||||||||****|
|**********||******|||**|
|**||||********||*******&
|||||||||||||||||||||||||
//

Key:
* - open space 
| - wall
$ - pot of gold
@ - outside
? - Marker