|||||||||||||||||||||||||||||||||||||||||||||||||||||||||||||||||||||||||||||||||||||||||||||||||||
| | |$    $     #     |     $           |   |$$ | $   |      $$$      $   |$$       $$$           |
| |$| | ||| ||| | ||| ||||| | ||||||||| | | | |$| ||| | | ||||||||||| ||| | ||||||||||||| ||||||| |
|$|   | $ | |   |   |   |   |   | $   | | |   | |   |   | $ $   $   |$|   |   |     |   |       | |
| ||||||| ||| ||||| ||| | | ||| ||||| | |$||||| ||| ||||||||||||||| | | ||||| | |$| | | | ||||| | |
|     $ | |   |   |   |   |$ $| $   |$| $ | $ | | $ |$    $    $    | |$  |   | | |   | | |     |$|
| |||||$| | ||||| |||$||||||| ||||| | | ||| ||| | ||||||||| ||||||||| ||| | ||| | ||||| ||| ||||| |
|$    |   | |     | |$  |$  |     |   |$ $|     |   |     |$|      $|   | |   | |     |  $| |   | |
| ||| ||||| |$||||| | | | | ||||||||| ||||||||||||| | ||| | | | ||| | | | ||| | | | | ||| ||| | |$|
|$$ |$|   |   |     | | | |         |   |    $    |  $|   |   | |   |$| |   $ | | | |   |$ $| | | |
||| | | |$||||| | ||| | | | ||||||| ||||| | ||| |$|||||$| ||| | | ||||| ||||||| | |||||$||| |$| | |
| | | | |     $ |   | |$  | |   |   |     |   |$|   |   |  $| | | $ |$  |       |   | |   | | | | |
|$| | | | | ||||||| |$||||||| | | ||| ||||||| | ||| | ||||| ||| ||| | |$| ||||||| | | |$| |$|$| | |
| | |   | | |   |   |         | |     |     | |$  | | |   |   |   |$|$| |       | |$  | | | $ | | |
| | | ||| ||| ||| |||||||||||||$| ||||| ||| | ||| | | | | ||| ||| |$| ||| ||||| | ||||| | |||||$| |
|   |  $|$$ |   |  $$       |   |    $|   |$  |   |   | |   |$  | | |   | |   | |$  |  $|     | | |
| ||||| | | ||| ||||||||||||| |$||||| ||| ||||| ||||||| ||| |||||$|$|||$|||$| | |$| ||||| ||||| | |
|   $ | |$|     |       |   | | | $$| |   |     |   | |$  |   $ | |   | |   | $ | |     | |     | |
|$||| | | |||||||$| ||| | |$| ||| | | |$|||$||||| | |$||| ||||| | ||| | | | ||||||||| | ||| ||||| |
|   | | | |   |  $|   | | |   |   |   |  $|$    | | $ |   |   |$  |  $|$  | |   |   | |   |$   $| |
||| | | ||| | |$| ||| | | ||||| |||||||$| ||||||| | |||$||| |$||||| ||||||| |$|||$| ||||| | |||$| |
| | | | |   |$| | |$  | |   |  $| $   | | |$$ $$  | |$$ |   |  $|   |       |  $  |       | $ | |$|
| | | | | |||$| | | ||| ||| ||||| ||| ||| | | ||||| | | | ||||||| ||||||| ||||||||||||| ||||||| |$|
| | |$|   |$| $ | |   |$|   | $$| |   |   | |     | |$| |   | |   |     |  $$   | $   |   |   | | |
| | | |||||$||||||||| | | ||| | | | | | ||| | ||||| | ||||| | | |||||||$| ||||||| ||| ||| |$|$| | |
| | | |     |    $  | | |   | |   | | | |   | |$    | $   | | |         |  $|$    |   |   |$|   |$|
| | | | |$||| | ||| | | | | ||||||| | |$| ||| | ||||||||| | | ||||||||||||||| ||||| ||| ||| ||||| |
|   |   | |   |   |   | | |   |$  | | |$  | $$|$    $  $|   | $ $    $    |   |$    |  $|   |   |$|
| ||||||| | | ||||||||| | ||| | | |$||||| | ||||||||||| ||||||||||||||||| | ||| | ||||||| |$| | | |
|   |   | | |$  |   | $ |$|   | | |   $ | |  $        |   $$ $  |       | |   | |   |     | |$| | |
|$| | ||| | ||||| |$| ||||| ||||| ||||| | ||||||| ||| ||||||||| | | | | | | | |$|||||$||||| | | | |
| | |$    |    $| | |$|   |       |   | |    $ $| | | $$  $   |   | | |$  | |$|   $$|   |$$$| |$| |
| | ||||||||||| | ||| |$| ||||||||| |$| |$|$||| | | ||||||||| ||||| ||| ||| | ||||| ||| |||||$|$| |
| |          $|   |   | | $      $$ |   | |$|   |   | $ |   | |   |   |$  | | |   |     | $ | |   |
| ||||||||||| ||||| |||$| | ||||||||||||| | | ||||||| | |$| | ||| | | ||| |$| | |$||||||| | | |||||
|  $| $ $  $| |   |   $ | | |     $ | |  $| | |$  |   |   | |   | | | | | | |  $| |       | $ |   |
||| |$||||| | ||| | ||| | ||| |||||$| | ||||| |$| | ||||||| ||| | |$| | | | ||||| | ||||||||||| |||
|   | |$  | |   | |   | |   |    $|  $| | |   | | | | $   |   | | | | |  $|    $| |$   $$  $$$|   |
| ||||| | | | | | ||| | ||| ||||| |||||$| | ||| | |$| |||$|$| | | ||| |||||$||||| ||||||||||| ||| |
|$  $   |   | |   |   |  $| |$$ |   |   | |$    |   |   | | | | |$$   |   | |   |           |    $|
| ||||||| ||| | ||| ||||| | | | |||$| ||| | ||||| |||||$| ||| | |||||||$| ||| | ||||||||||| | | |||
|  $    | | $ |$$ | $   | | $ |   |   | $ |     |$$   | |   | |         |   | |        $| $ | |   |
| ||||| | |$||||||| ||| ||| ||||| ||||| ||||||| |||||||$||| |$||||||||||||| | | |||||||||$| | |$| |
|     | | |  $|   |   |   | |   |       |   $ |   |     | |   |  $|   |   |   | $ |   $   | | | | |
||||| | ||||| | | ||| ||| | | | ||||||||| | |$||| | |||||$| ||| |$|$| | | | |||||||$|||||||||$| | |
| |   |$|  $  | |   |   | |   |      $|$  |$|   | | $     | |   |   |  $| |  $|   | |   | |   | | |
| | | | |$||||| |||$||||| | ||||||||| | ||||||| |$| ||||| ||| | ||| ||||| | | | | | | | | | ||||| |
|   | | |$  $ |   |     | |       |$  |     $ | | | |   |$|   |   |  $|$  | | | |$  | |$| |$| $ | |
||||||| | ||||||| ||||| |$|$||| | | ||||||||| | | |||$| ||| | ||| ||||| |||||$| ||||| |$| | ||| |$|
| $ |   |$ $|     | |  $| |$  | | |        $| | |$ $|$|$   $|   |$  |  $|$  | | $   | |$| |   | | |
| | | ||||| | ||||| | |||$||| | |$||||| ||| | ||||| | | ||||||| ||| |$|||$| ||||||| ||| | | | | |$|
| |   |$  | | $     |   | | | | |     | | |   |     | |$| $   |   | | | $ |   |$  | $ | | | |   | |
| ||||| | | | ||||||||| |$| | ||||||| | | | ||| ||||| | | | ||||| | | |$| ||| | |$||| | | ||||||| |
| $ $ |$| | |   |   | |$$ |   |   |   |   | |   |   | | | | |     | |$$ |$  |  $|$  | | | $ |   | |
| ||| | |||$|$| | | | | ||||||| ||| | |||||$| ||| | | | | | | |||||$||||||| ||||||| |$| | | | | | |
|$  |$|     | |   |   |       | $   | |   | |     | $ |  $|$|$  |$  |     |     |   | | | |   | $ |
||| | ||||||| | ||||||||||||| ||||||||| | | ||||||||||||||| ||| | ||||| |$|$||| | | | |$|||||||||||
|   |$    | | |$    |    $  | |   $ $ | | |    $$   |   |$  | | |  $  | |$|   | | | | | | $ $     |
| | ||||| | | ||||| | |||||$|$| | ||| | |$||||||||||| | | ||| |$||||| | | ||| | | ||| | | ||||||| |
|$| |     | | |   |$| |     | |$| $ |   |  $    |   |$|$|     | |   | | | | | | | $$|  $| |    $| |
| ||| ||||| | | | | | | ||||| | ||||| ||||||||| | |$| |$|||||$| |$| | ||| |$| | |||$||||||| | | |$|
| |$  |     | |$|  $| |   |   |$  $ |         | | |$  |    $| | | |$  |  $| $ | | |$  $     |$|   |
| | | |$||||| | ||||| | | | ||||||| ||||||||| | | ||||||||| ||| | ||||| | ||||| | ||||| |$|||$|||||
| | | |       |$   $  | | |$ $|   | |         | |   |   | | $ | |$ $    |   |   |  $  | | |   | $$|
| | | ||||| ||||||||||| |$| | |$| | | ||| ||||| | | | |$| | | | ||||||||||| | | |||||$| | | |||$| |
| | | |$$$|   |    $|   | |$|   |$$ |$  | | $   | | $ |  $| | | | $  $| |   | | |   | |$|$| |$$ |$|
| | ||| | ||| |$| | | ||| |||||||||$||| | |$||||||||||| ||||| | |$||| | | |||$|||$|$| | ||| | |$| |
| |    $|$  | | | | | | |$    |   | |   | |       |   |   | $ |   |  $|   | |  $| | | |$|   | | |$|
| ||||||| | | | | | |$| | ||| |||$||| |||$| ||||| | | | | | |||||||$||||||| | | | | | |$| ||| | | |
| | $   | | |   | | |   | |   |   |  $|  $|$  |   |$| | | |         |  $  | | |   |   | |   | | | |
| ||||| | | ||||| |$||||||| | | | | ||||||||||| ||||| | | |||||||||||$|$| |$| ||||| ||| |||$| ||| |
|       | | |   | | |   |   | | |$|   |      $|     | | |           | | | | | |   | | |   | | |   |
| ||||||| | | | | | | | | ||||| | ||| | ||||| | ||| | | ||||||||||| | | |$| | |||$| | | |$| | | |||
|     |   | | | | |   | | $     |   | | |   | |$  |   |         |   | |$|  $|     |$  | |$|   |$ $|
| ||| | ||| | |||$| ||||| ||||||||| | | | | |$|||$|||||||||||||$| |||$| ||||| ||||||||| | ||||||| |
|   | |  $| |     |$| $ |       |   |$|$| |   |$  |         | | |  $  |    $|  $   $  | |     |   |
||| | ||||| ||||| ||| | ||| ||||| ||| ||| ||||||||| | ||||| | | ||||||||| | ||||||||| | |||||$| |||
|   |$$ |   |   | |   |   |   |   |   |$  | $   | $ | |   $ | |     |   | | $ |  $  | |   |$| |   |
||||||| | ||| | ||| | |||$||| | ||| |||$||| | | | ||| | ||||| | ||| ||| ||||| | ||||| | | | | ||| |
| $ |   | | $ | $   | |$ $|$  |   |   |   | |$|  $| |$|       |   |$$ |   |   |$  |   | |   | | | |
| | | |||$| |$||||||| |$| | ||| | | |$||| | ||||||| |$||| |||||||||||$|||$| ||||| | | | ||||| | |$|
| |   |   |$|       | | | |   | | | |     |  $$$|   | $ |$|     |   $$|$  | |   |   | | $ |$  | | |
| ||||| ||| | | ||| | | |$|||$||| ||||||||||||| | ||||| | | | | | ||||| ||| ||| ||||| ||| | ||| | |
|   |   |   | | |   |$| |   |   |   |         |$|      $| | | | |$|   |$| |   $$| $ | |   |  $$ | |
| |||$||| ||| ||| ||| |$||| ||| ||| | ||||||| | | |||||||$| ||| |$| | | | |$||| | |||$| ||||||||| |
| |   |   |$  |   |$  | |  $| |$  |   | |$  | | |   $  $|   |$  |   |   | | $ | | $ | | $     |   |
||| ||| | | ||| |||$||| | ||| | | | ||| | | | |$||| ||| ||||| ||||||||||| ||| ||||| | | ||||| |$| |
|  $|   | |   | |   |   |     | | | |   | |   |  $|   | |   |          $  |$|   | |   |     | |$| |
| ||| ||| |||||$| ||| ||||||||| | ||| | | |||||||$|||$| | | ||||||||||||||| | | | | ||||||||| | |||
|   $ |$  |   $ | |  $|$$ | |   |     | |       |   |$| | |     | $   |     | |$$ |   |   |$  | $ |
||||||||||| ||||| | ||||| | | | ||||||| |||||||$||| | | | ||||| ||| | | ||||||||||||| |$| |$| ||| |
|   | $ | $ |    $|  $$ |$|   |     $ |$ $ $  |   |$| |   |   | $ | | | |     $ |    $| |   | | $ |
| | | | |$|||$| ||||||| | ||||||||||| | |||$| ||| | | |||||$| |||$||| | | ||||| | ||||| ||||||| |||
| |   | |   | | |   |   | |   |  $|  $|   | | $ |   |       |   |  $  |$|   | $ |     |   |   | | |
|$| ||||||| | ||| | | ||| ||| | ||| ||||| | ||| | ||||||||||| | ||||||| | ||| ||||||||||| | | | |$|
| |   |$  | |   | | |   | |   | $   | $ $$|   | |$    $$|$$ | |      $| | |   |   |  $  |   |$| | |
| ||||| | | | | | |$||| | |$||||||||||||||||||| | ||||| ||| | ||||||| | | |$||| |$| | |$||||| | | |
|$      |   | | $ |   |  $|           $         |     |$   $|       |$  | |     |$  | |     $ |   |
|||||||||||||||||||||||||||||||||||||||||||||||||||||||||||||||||||||||||||||||||||||||||||||||||||
