|||||||||||||||||||||||||||||||||||||||||||||||||||||||||||||||||||||||||||||||||||||||||||||||||||||
|               | |                 |     |   |     |   |   |   |   | |       |       |         | | |
| ||||||||| ||||| ||| ||| ||||| ||||| ||||| ||| ||||||| | ||| ||| ||| | ||||||| ||||||| ||||||||| | |
|         |             |     |   |                                               |   |           | |
| | | | ||| ||||| ||||||||||| ||||| ||||| ||| ||||||||| ||| | ||||| | ||| | ||||||| ||| ||||| ||| | |
| | | |   |   | |           |           | | |   |     | | | |   | | |   | |               | | | | | |
| | ||| ||||||| ||| ||||||||||||||| ||||||| ||||| ||||||| ||||| | ||||| ||| | ||||| | | ||| ||| ||| |
| |   |           |         |     |               | | | |     |       |   | |     | | |             |
| | | | | | | | | | | | ||||| ||| | ||| | | ||||| | | | | ||| | ||||| ||||||| | ||| ||| | ||| |||||||
| | | | | | | | | | | |         | |   | | |     |           | |     |       | |   |   | |   |     | |
| | | | ||| | ||| ||| ||| ||||| | ||||| ||||| | ||| | ||||||| | | ||| ||||||| | ||| | | ||||| ||||| |
| | | |   | |   |   |   |     | |   | |     | |   | |       | | |   |       | |   | | |     |     | |
| | | ||||||| | ||||| | | ||| | | ||| ||||| | | | | ||| | | | ||| | ||||||||| ||| | ||| ||||||||||| |
| | |       | |     | | |   | | |         | | | | |   | | | |   | |     |   | | | |   | | |   |     |
| | | | ||| | ||| ||||| | | ||||| | ||| ||||||| ||||| | | ||| | ||||| ||| ||||| ||||||||| | ||| |||||
| | | |   | |   |     | | |     | |   |       |     | | |   | |     |         | |   | | |           |
| | | ||||||||||| | | | ||||| | | | | | | | ||| | | | | ||||| ||||| ||||||||||| | ||| | | |||||||||||
| | |           | | | |     | | | | | | | |   | | | | |     |     | |       |       |     |         |
| | | ||| | | | | ||| | | | ||||| | | ||||| ||| | ||| | | ||||||||||| ||||| | ||| ||| ||||| |||||||||
| | |   | | | | |   | | | |     | | |     |   | |   | | |     | |         |     |     |       |   | |
| | | ||| | | ||| ||||||| | | | | | | ||||| | ||| ||||| | ||||| | ||| | ||||||||| ||||| ||||||| ||| |
| | |   | | |   |       | | | | | | |     | |   |     | |           | |         |   |     |         |
| ||| | ||| | ||| | | ||||| ||| ||| | ||| ||||||||||| | ||| ||| | ||||||||| | ||| | | ||||| ||||| |||
| |   |   | |   | | |     |   |   | |   |           | |   |   | | | |     | |   | |             |   |
| | | ||||||| | | ||||||| | ||| ||||||||||||| | ||||||||| ||||||||| | ||| | | | ||||||||| | |||||||||
| | |       | | |       | |   |     | | | | | |         |         |     | | | |         | |     |   |
| ||| ||| | | ||| | | | ||| | ||||||| | | | ||||||||||||||||||||||| ||||||||||||||| | | | | | | | |||
| |     | | |   | | | |   | |       |       |   |   | | |   | |                   | | | | | | |     |
| ||| | | | | | | | | | ||| | | | ||| ||| ||| ||| ||| | | ||| | ||| | ||||||| ||||| ||| | | ||| | | |
|   | | | | | | | | | |   | | | |       |         |               | |       |     |   | | |   | | | |
| | | | | | | ||| ||| | | ||| ||| ||||| ||| ||||||| ||||| ||| ||| | | | ||| ||| | | ||||| | ||||| |||
| | | | | | |   |   | | |   | |       |   |             |   |   | | | |   |   | | |     | |     |   |
| | ||| ||||| ||| | | ||| | | ||| | ||||| ||||||| | | | | | | | | ||||| ||| | | | | ||||| | |||||||||
| |   |   | |   | | |   | | |   | |     |       | | | | | | | | |     |   | | | | |     | |         |
| | | | ||| ||||| ||||||| | | | | | | ||||| | | ||| | | | ||| ||||||| | | ||| ||||| | | | | | | |||||
| | | |         |       | | | | | | |     | | |   | | | |   |       | | |   |     | | | | | | |     |
| ||| | ||||| | ||||| | | ||||| | ||| | | | ||||||||||| | ||||||||| ||| ||||||| ||| ||| ||||||||||| |
| |   |     | |     | | |     | |   | | | |       @   | |         |   |       |   | | |       |   | |
| | | | ||| ||||| | | | | ||| | | ||| ||||| | ||| ||||| | | ||||| ||||||||||||| ||| | ||| | ||| |||||
| | | |   |     | | | | |   | | | |       | |   |     | | |     |           |     |     | |         |
| | | | ||||| ||||| | | | | | | ||| | ||| | | | ||| ||||| | ||||| | ||||||| ||||||||||||||||||| | | |
| | | |     |     | | | | | | |   | |   | | | |   | | | | |     | |       |                   | | | |
| ||| | | | | ||| ||| | | | | | ||| | | | | ||| ||||| | ||| | | ||| | ||||||||| ||||||||||||||| | |||
| |   | | | |   |   | | | | | |   | | | | |   |           | | |   | |         | |             | |   |
| | | | | | | | ||||||| | | ||| | | | ||||||| | | | ||| ||| ||| | ||| | | | | | | ||| ||||||| | |||||
| | | | | | | | | |   | | |   | | | |       | | | |   |   |   | |   | | | | | |     |       | |   | |
| | | | | ||| ||| | ||||| | ||| | | | | | | | ||| ||||||| ||| | | ||| | ||||||||| ||| ||| ||||||||| |
| | | | |   |           | |   | | | | | | | |   |       |   | | |   | |         |   |   |           |
| | | | ||| | ||| ||| | | | ||||| | | ||| | | ||| | | ||||| ||| | ||||||||||||| ||| | | ||| ||||||| |
| | | |   | |   |   | | | |     | | |   | | |   | | |     |   | |             |   | | |   |       | |
| | | | | | | | | | ||||| | | ||| | | ||||| | | | ||||| ||| ||| | | | | | ||| | ||||| | ||||||||||| |
| | | | | | | | | |     | | |   | | |   |   | | |     |   |   | | | | | |   | |     | |           | |
| | | | | ||||| | ||| | | | ||| ||||| ||| ||| | | | | | | | ||| | | | | | | | | ||| ||| ||| ||| ||| |
| | | | |     | |   | | | |   |     |   | |   | | | | | | |   | | | | | | | | |   |   |   |   |   | |
| | ||| | | | | | ||| | | | | | ||||| | | | | | | ||| | | | | | | ||| ||| ||| | ||||||| ||| ||||| |||
| | |   | | | | |   | | | | | |     | | | | | | |   | | | | | | |   |   |   | |       |   |     |   |
| ||||| | | | ||||| | | ||||| ||| | | | | ||| ||||||||| | | ||| | | | ||| ||||||||||||||||||||||||| |
|   |   | | |     | | |     |   | | | | | |           | | |   | | | |   |                         | |
| ||||| | | | | | ||| | | ||| ||||||| | ||||| ||| | | ||| | | ||| ||| | | | ||||| | | ||||||||| | |||
|     | | | | | |   | | |   |       | | |       | | |   | | |   |   | | | |     | | |         | |   |
| | | | | | | | | | ||||| | ||| | | ||| | | | | ||| ||||| ||| | ||||||||| ||||||||||||||||||| | ||| |
| | | | | | | | | | |   | |   | | |   | | | | |   |     |   | |         |                   | |   | |
| | ||| | | ||| | ||| ||| | | | | ||| ||||| | ||||| ||||||||| ||| ||| | | ||| ||||||| ||||| |||||||||
| |   | | |   | |       | | | | |   |     | |     |         |   |   | | |   |       |     |         |
| | | | | | | | | ||| | | | ||| | ||||| ||| | | ||| | | ||||| | ||| | | ||||||| ||||||| | | | ||| |||
| | | | | | | | |   | | | |   | |     |   | | |   | | |     | |   | | |       |       | | | |   |   |
| | ||||| | | | ||| | | | | ||| | | | ||||| | | ||| ||||| ||| ||||||||| | ||| ||||||||| | | | | |||||
| |     | | | |   | | | | | |   | | |     | | |   |     |   |         | |   |         | | | | |     |
| ||||||| ||||| | | ||||| ||||| ||| | ||| | | | ||| | | | ||||||||||||| | | ||||||| ||||| ||||| | |||
|       |     | | |     |     |   | |   | | | |   | | | |           |   | |       |     |     | |   |
| ||| | | ||||| ||| ||||||||| | ||| ||||||| | | ||||| ||||||| ||| ||||| | | | ||||||||||||| | | |||||
|   | | |     |   |         | | |         | | |   |         |   |   |   | | |             | | |     |
| | ||||| | ||| ||||||||||| | | ||| ||| ||| | | ||||| | ||||| ||| | ||| | | ||| ||| ||| ||||||| |||||
| |     | |   |           | | | |     |   | | |   |   |     |   | |   | | |   |   |   | |     |     |
| ||||||||||||| ||||||| | | | ||||| | | | | | ||||||| ||| | | ||||| ||||| | ||||| ||||||| |||||||||||
|             |       | | | |     | | | | | |     |     | | |     |     | |     |                   |
| ||||||| | ||| | ||| ||||||| ||||| | | ||||| ||| ||| ||| ||| | ||| | ||| | | | | |||||||||||||||||||
|       | | |   |   |       |     | | | |       |   |   |   | |   | |   | | | | | |       |         |
| | ||||||| | | | | | | | | | | ||| ||||||||| | | ||| ||| | | | | | | ||||| | | | | ||||||| ||| | | |
| |     |   | | | | | | | | | |   |       |   | |   |   | | | | | | |     | | | |             | | | |
| | | ||| | | | | ||||| | | | | ||||| | ||||| ||| | | ||| | | | | ||| | | | | ||| | ||| | ||||| | | |
| | |   | | | | |     | | | | |     | |   |     | | |   | | | | |   | | | | |   | |   | |     | | | |
| | | ||| | | | | | | | | | | | ||| ||| | ||| ||| | ||| ||| ||| | ||| | ||||| ||| | | ||||| | ||| |||
| | |   | | | | | | | | | | | |   |   | | |     | |   |   |   | |   | | |       | | |     | |   |   |
| ||| ||||| | | | | ||| | ||||||||||| | ||||| ||||| | | ||||| | ||| ||||||||| ||||| | | ||| ||| ||| |
|   |     | | | | |   | |           | | | |     |   | |     | |   |     |         | | |   |   |   | |
| ||| | | | | | | | | | | | | | | | | ||| | | | | | | | ||||| ||||||||||||| | | | | | | | | | | | |||
|   | | | | | | | | | | | | | | | | | | |   | | | | | |     |             | | | | | | | | | | | |   |
| | ||| | | ||| | | | ||| ||| | | | | | ||| | | | | | | | | | | | | ||| | | | | ||| | | | ||||| | |||
| |   | | |   | | | | |     | | | | |     | | | | | | | | | | | | |   | | | | |   | | | |     | |   |
| | ||| | | | | | | | ||| | | ||| ||| | | | | ||| | ||||||| | | | | ||||| | ||| ||||| ||| ||||||||| |
| |   | | | | | | | | |   | |   |   | | | | |   | |       | | | | |     | | |       | |           | |
| ||||| | | | | | ||| ||| ||| | ||||| ||| ||| ||| | ||| ||| | ||| ||||||||||| | | | ||||| | | | | | |
|     | | | | | | |   |     | |     |   |   |   | |   |   | |   | | |   | | | | | |     | | | | | | |
| ||| | | | ||| | | ||| | | | | ||| | | ||| | | | | | ||||| | | ||| | ||| | ||| | | ||||||| ||| | | |
|   | | | |   | | | |   | | | |   | | |   | | | | | |     | | |             |   | |       |   | | | |
| | | ||| | | | | ||| | | | | | | ||| | ||| | | ||| | ||||| | | | | | ||||||| | | | | | ||| | | | |||
| | | |   | | | | |   | | | | | |   | | | | | |   | |     | | | | | | |     | | | | | |   | | | |   |
| | | | | ||| | ||||| | | ||||||| ||| ||| ||| | ||| ||| ||| | | ||| | | ||||||| ||| ||||| ||| ||| | |
| | | | |   | | |     | |       |   |     |   |   |   | |   | |   | |       |     |     |   |   | | |
|||||||||||||||||||||||||||||||||||||||||||||||||||||||||||||||||||||||||||||||||||||||||||||||||||||
